+--+--+--+--+--+--+--+--+--+--+
|  |        |           |     |
+  +  +--+  +  +  +--+  +  +--+
|     |  |  |  |  |  |  |     |
+--+--+  +  +--+  +  +  +--+  +
|        |        |  |     |  |
+  +  +--+--+--+--+  +--+  +  +
|  |           |        |  |  |
+  +--+--+  +--+  +--+  +  +  +
|        |           |  |     |
+--+--+  +--+--+--+--+  +--+  +
|  |     |     |        |     |
+  +  +--+  +--+  +--+  +  +--+
|     |     |     |     |     |
+  +--+--+  +  +--+--+  +--+  +
|     |     |        |     |  |
+--+  +  +  +--+--+  +--+--+  +
|     |  |     |  |  |     |  |
+  +--+  +--+  +  +  +  +  +  +
|        |        |     |     |
+--+--+--+--+--+--+--+--+--+--+